1111111111111
10000000000E1
1P1C1C1C1C111
1111111111111