11111111111111
1C10C00C0000E1
1P0C0000C00011
11C0C0C00000C1
10C11C1C10C101
10100C011C1C01
1C001C0C1C10C1
11111111111111