1111111111111111111
1P0C010CE1C00C100C1
101C0C0011C00010111
1C10C0C000111000C11
11111100100000100C1
1111C000C0010011111
1110001100011000C11
1C0C0110C1000C01111
1010110000111100C11
1C1C00C110C1C0C0111
1111111111111111111