1111111111
1P0C0C00E1
1111111111