1111111111
1P000C0E01
1111111111