1111111111
1000000001
1P1E10C1C1
1111111111